# Pixel pigeon silhouette map
# Edit cells: 0 = empty, 1 = active
# Each row must stay exactly 55 characters wide (55 cols x 68 rows)
0000000000000000000000000000000000000000000000000000000
0000000000000000000000000000000000000000000000000000000
0000000000000000000000000000000000000000000000000000000
0000000001100000000000000000000000000000000000000000000
0000000011100000000000000000000000000000000000000000000
0000000111100000000011111110000000000000000000000000000
0000000111000000001111111111000000000000000000000000000
0000000111000000011111111111110000000000000000000000000
0000000111100000011111111111110000000000000000000000000
0000000001110000011111111111111000000000000000000000000
0000000000010000011111111111111000000000000000000000000
0000000000010000001111111111111000000000000000000000000
0000000000011000011111111111110000000000000000000000000
0000000000011100011111111111111000000000000000000000000
0000000000001101111111111111111100000000000000000000000
0000000000111111111111111111111000000000000000000000000
0000000001111111111111111111100000000000000000000000000
0000000111111111111111111111100000000000000000000000000
0000000111111111111111111111100000000000000000000000000
0000000111111011111111111111100000000000000000000000000
0000001111111101111111111111110000000000000000000000000
0000001111111001111111111111110000000000000000000000000
0000111111111011111111111111110000000000000000000000000
0000111111111011111111111111110000000000000000000000000
0001111111111011111111111111110000000000000000000000000
0001111111111111111111111111111000000000000000000000000
0001111111111111111111111111111111000000000000000000000
0001111111111111111111111111111111100000000000000000000
0111111111111111111111111111111111110000000000000000000
0111111111111111111111111111111111111000000000000000000
0111111111111111111111111111111111111000000000000000000
0111111111111111111111111111111111111100000000000000000
1111111111111111111111111111111111111110000000000000000
1111111111111111111111111111111111111110000000000000000
0111111111111111111111111111111111111111100000000000000
0111111111111111111111111111111111111111100000000000000
0111111111111111111111111111111111111111100000000000000
0111111111111111111111111111111111111111100000000000000
0111111111111111111111111111111111111111110000000000000
0111111111111111111111111111111111111111110000000000000
0011111111111111111111111111111111111111111000000000000
0001111111111111111111111111111111111111111000000000000
0001111111111111111111111111111111111111111000000000000
0001111111111111111111111111111111111111111100000000000
0000111111111111111111111111111111111111111100000000000
0000001111111111111111111111111111111111111111110000000
0000000111111111111111111111111111111111111111111110000
0000000000011111111111111111111111111111111111111111111
0000000000011111111111111111111111111111111111111111111
0000000000001111111111111111111111111111111111111111111
0000000000000111111111111111111111111111111111111111100
0000000000000011111111111111111111111111111111111111100
0000000000000011111111111111111111111111111111111111100
0000000000000001111111111111111111111111111111111110000
0000000000000000001111111111111111111111111111111000000
0000000000000000000011111111111111000001111111111100000
0000000000000000000011111111111110000000011111111110000
0000000000000000000000110001111100000000000011111111000
0000000000000000000001110000110000000000000000011111000
0000000000000000011111100000110000000000000000000000000
0000000000000011111111100001110000000000000000000000000
0000000000000111111111111101110000000000000000000000000
0000000000000000001111111111111111000000000000000000000
0000000000000000011111111111111111100000000000000000000
0000000000000000011111111111000000000000000000000000000
0000000000000000000000011110000000000000000000000000000
0000000000000000000000011100000000000000000000000000000
0000000000000000000000010000000000000000000000000000000
